PP~~~~~~~~~PP
PB~B~B~B~B~BP
~~~~~~~~~~~~~
~B~B~B~B~B~B~
~~~~~~~~~~~~~
~B~B~B~B~B~B~
~~~~~~~~~~~~~
~B~B~B~B~B~B~
~~~~~~~~~~~~~
~B~B~B~B~B~B~
~~~~~~~~~~~~~
PB~B~B~B~B~BP
PP~~~~~~~~~PP