############
#        O #
#   P   ####
#          #
#          #
#  O       #
#          #
#          #
#  ##   XX #
#       #  #
#########  #
        # ##
